%More information about data and methods for calculation of global sea level 
%and errors can be found in " Recent global sea level acceleration started 
%over 200 years ago?", Jevrejeva, S., J. C. Moore, A. Grinsted, and P. L. Woodworth (2008), 
% Geophys. Res. Lett., 35, L08715, doi:10.1029/2008GL033611.
%
% Downloaded from https://www.psmsl.org/products/reconstructions/jevrejevaetal2008.php
% 
%Description of the file: 
%(1) time (year) 
%(2) global sea level (mm) 
%(3) error of the rate (mm) 
% 
  1.7000000e+003 -1.5200000e+002  6.5000000e+001
  1.7010000e+003 -1.5800000e+002  6.5000000e+001
  1.7020000e+003 -1.3200000e+002  6.5000000e+001
  1.7030000e+003 -1.7200000e+002  6.5000000e+001
  1.7040000e+003 -1.3500000e+002  6.5000000e+001
  1.7050000e+003 -1.6700000e+002  6.5000000e+001
  1.7060000e+003 -1.9200000e+002  6.5000000e+001
  1.7070000e+003 -1.5300000e+002  6.5000000e+001
  1.7080000e+003 -1.4900000e+002  6.5000000e+001
  1.7090000e+003 -1.8700000e+002  6.5000000e+001
  1.7100000e+003 -1.6800000e+002  6.5000000e+001
  1.7110000e+003 -1.4000000e+002  6.5000000e+001
  1.7120000e+003 -1.2900000e+002  6.5000000e+001
  1.7130000e+003 -1.5100000e+002  6.5000000e+001
  1.7140000e+003 -1.0600000e+002  6.5000000e+001
  1.7150000e+003 -1.7200000e+002  6.5000000e+001
  1.7160000e+003 -1.6800000e+002  6.5000000e+001
  1.7170000e+003 -1.6400000e+002  6.5000000e+001
  1.7180000e+003 -1.8500000e+002  6.5000000e+001
  1.7190000e+003 -1.8200000e+002  6.5000000e+001
  1.7200000e+003 -1.0900000e+002  6.5000000e+001
  1.7210000e+003 -1.4600000e+002  6.5000000e+001
  1.7220000e+003 -1.4100000e+002  6.5000000e+001
  1.7230000e+003 -9.9000000e+001  6.5000000e+001
  1.7240000e+003 -1.4500000e+002  6.5000000e+001
  1.7250000e+003 -1.6600000e+002  6.5000000e+001
  1.7260000e+003 -1.0800000e+002  6.5000000e+001
  1.7270000e+003 -1.3600000e+002  6.5000000e+001
  1.7280000e+003 -1.9500000e+002  6.5000000e+001
  1.7290000e+003 -1.7600000e+002  6.5000000e+001
  1.7300000e+003 -1.4800000e+002  6.5000000e+001
  1.7310000e+003 -1.0800000e+002  6.5000000e+001
  1.7320000e+003 -1.3400000e+002  6.5000000e+001
  1.7330000e+003 -1.6000000e+002  6.5000000e+001
  1.7340000e+003 -1.6500000e+002  6.5000000e+001
  1.7350000e+003 -1.8100000e+002  6.5000000e+001
  1.7360000e+003 -1.0900000e+002  6.5000000e+001
  1.7370000e+003 -9.2000000e+001  6.5000000e+001
  1.7380000e+003 -1.5200000e+002  6.5000000e+001
  1.7390000e+003 -1.2300000e+002  6.5000000e+001
  1.7400000e+003 -1.2400000e+002  6.5000000e+001
  1.7410000e+003 -1.2200000e+002  6.5000000e+001
  1.7420000e+003 -1.5400000e+002  6.5000000e+001
  1.7430000e+003 -1.4400000e+002  6.5000000e+001
  1.7440000e+003 -1.4800000e+002  6.5000000e+001
  1.7450000e+003 -1.7800000e+002  6.5000000e+001
  1.7460000e+003 -1.7800000e+002  6.5000000e+001
  1.7470000e+003 -1.4200000e+002  6.5000000e+001
  1.7480000e+003 -1.4700000e+002  6.5000000e+001
  1.7490000e+003 -1.6700000e+002  6.5000000e+001
  1.7500000e+003 -1.5278700e+002  6.5000000e+001
  1.7510000e+003 -1.2178560e+002  6.5000000e+001
  1.7520000e+003 -1.6245650e+002  6.5000000e+001
  1.7530000e+003 -1.6669970e+002  6.5000000e+001
  1.7540000e+003 -1.5393680e+002  6.5000000e+001
  1.7550000e+003 -1.5788700e+002  6.5000000e+001
  1.7560000e+003 -1.5715660e+002  6.5000000e+001
  1.7570000e+003 -1.3961140e+002  6.5000000e+001
  1.7580000e+003 -1.5277390e+002  6.5000000e+001
  1.7590000e+003 -1.2855930e+002  6.5000000e+001
  1.7600000e+003 -1.5530230e+002  6.5000000e+001
  1.7610000e+003 -1.2159160e+002  6.5000000e+001
  1.7620000e+003 -1.3384610e+002  6.5000000e+001
  1.7630000e+003 -1.2230860e+002  6.5000000e+001
  1.7640000e+003 -1.2485660e+002  6.5000000e+001
  1.7650000e+003 -1.6117290e+002  6.5000000e+001
  1.7660000e+003 -1.7500000e+002  6.5000000e+001
  1.7670000e+003 -1.1100000e+002  6.5000000e+001
  1.7680000e+003 -1.2035700e+002  6.5000000e+001
  1.7690000e+003 -1.1679150e+002  6.5000000e+001
  1.7700000e+003 -1.2152050e+002  6.5000000e+001
  1.7710000e+003 -1.0459850e+002  6.5000000e+001
  1.7720000e+003 -1.2774500e+002  6.5000000e+001
  1.7730000e+003 -1.3633400e+002  6.5000000e+001
  1.7740000e+003 -2.1480933e+002  6.5000000e+001
  1.7750000e+003 -1.2175233e+002  6.5000000e+001
  1.7760000e+003 -1.9822433e+002  6.5000000e+001
  1.7770000e+003 -1.7074567e+002  6.5000000e+001
  1.7780000e+003 -1.4596700e+002  6.5000000e+001
  1.7790000e+003 -1.2957550e+002  6.5000000e+001
  1.7800000e+003 -1.3088950e+002  6.5000000e+001
  1.7810000e+003 -1.3533150e+002  6.5000000e+001
  1.7820000e+003 -1.4822100e+002  6.5000000e+001
  1.7830000e+003 -1.4687350e+002  6.5000000e+001
  1.7840000e+003 -1.8270500e+002  6.5000000e+001
  1.7850000e+003 -1.8983133e+002  6.5000000e+001
  1.7860000e+003 -1.7835950e+002  6.5000000e+001
  1.7870000e+003 -1.6583600e+002  6.5000000e+001
  1.7880000e+003 -2.1122367e+002  6.5000000e+001
  1.7890000e+003 -2.1876033e+002  6.5000000e+001
  1.7900000e+003 -1.5487600e+002  6.5000000e+001
  1.7910000e+003 -1.5529333e+002  6.5000000e+001
  1.7920000e+003 -1.5478800e+002  6.5000000e+001
  1.7930000e+003 -1.8989900e+002  6.5000000e+001
  1.7940000e+003 -1.1800000e+002  6.5000000e+001
  1.7950000e+003 -1.2100000e+002  6.5000000e+001
  1.7960000e+003 -1.5700000e+002  6.5000000e+001
  1.7970000e+003 -1.3400000e+002  6.5000000e+001
  1.7980000e+003 -1.3500000e+002  6.5000000e+001
  1.7990000e+003 -1.7700000e+002  6.5000000e+001
  1.8000000e+003 -1.7500000e+002  6.5000000e+001
  1.8010000e+003 -1.1740000e+002  6.5000000e+001
  1.8020000e+003 -1.2895000e+002  6.5000000e+001
  1.8030000e+003 -2.0250000e+002  6.5000000e+001
  1.8040000e+003 -2.3355000e+002  6.5000000e+001
  1.8050000e+003 -1.8660000e+002  6.5000000e+001
  1.8060000e+003 -1.3015000e+002  6.5000000e+001
  1.8070000e+003 -9.4200000e+001  6.5000000e+001
  1.8080000e+003 -1.4884093e+002  6.5000000e+001
  1.8090000e+003 -1.6320630e+002  6.5000000e+001
  1.8100000e+003 -1.2804620e+002  6.5000000e+001
  1.8110000e+003 -1.3184074e+002  6.5000000e+001
  1.8120000e+003 -9.5848611e+001  6.5000000e+001
  1.8130000e+003 -1.0606417e+002  6.5000000e+001
  1.8140000e+003 -1.2687472e+002  6.5000000e+001
  1.8150000e+003 -1.0989708e+002  6.5000000e+001
  1.8160000e+003 -9.0110416e+001  6.5000000e+001
  1.8170000e+003 -7.3042500e+001  6.5000000e+001
  1.8180000e+003 -9.8426389e+001  6.5000000e+001
  1.8190000e+003 -1.0459756e+002  6.5000000e+001
  1.8200000e+003 -1.3250889e+002  6.5000000e+001
  1.8210000e+003 -8.9194445e+001  6.5000000e+001
  1.8220000e+003 -8.1077917e+001  6.5000000e+001
  1.8230000e+003 -1.0786069e+002  6.5000000e+001
  1.8240000e+003 -8.5140000e+001  6.5000000e+001
  1.8250000e+003 -8.2156389e+001  6.5000000e+001
  1.8260000e+003 -1.5881343e+002  6.5000000e+001
  1.8270000e+003 -1.4682694e+002  6.5000000e+001
  1.8280000e+003 -1.2944689e+002  6.5000000e+001
  1.8290000e+003 -1.5573524e+002  6.5000000e+001
  1.8300000e+003 -1.6001783e+002  6.5000000e+001
  1.8310000e+003 -1.4200794e+002  6.5000000e+001
  1.8320000e+003 -1.4196674e+002  6.5000000e+001
  1.8330000e+003 -1.3277032e+002  6.3951604e+001
  1.8340000e+003 -8.4556803e+001  6.3305304e+001
  1.8350000e+003 -1.0114172e+002  6.2563369e+001
  1.8360000e+003 -7.9148982e+001  6.1733082e+001
  1.8370000e+003 -8.7878450e+001  6.0818894e+001
  1.8380000e+003 -1.0103769e+002  5.9824616e+001
  1.8390000e+003 -1.0945905e+002  5.8758532e+001
  1.8400000e+003 -1.3371454e+002  5.7623167e+001
  1.8410000e+003 -1.2634379e+002  5.6402478e+001
  1.8420000e+003 -1.4895944e+002  5.5095021e+001
  1.8430000e+003 -1.0899638e+002  5.3712710e+001
  1.8440000e+003 -9.0341095e+001  5.2254947e+001
  1.8450000e+003 -1.3993732e+002  5.0731009e+001
  1.8460000e+003 -9.8696749e+001  4.9151028e+001
  1.8470000e+003 -1.5289342e+002  4.7520810e+001
  1.8480000e+003 -1.5995717e+002  4.5841746e+001
  1.8490000e+003 -1.1253191e+002  4.4115072e+001
  1.8500000e+003 -8.7393442e+001  4.2335258e+001
  1.8510000e+003 -7.0236330e+001  4.0510534e+001
  1.8520000e+003 -6.2919602e+001  3.8651126e+001
  1.8530000e+003 -4.8999679e+001  3.6759629e+001
  1.8540000e+003 -9.1646284e+001  3.4847571e+001
  1.8550000e+003 -9.2821303e+001  2.7911216e+001
  1.8560000e+003 -1.3277018e+002  2.1447641e+001
  1.8570000e+003 -1.4156906e+002  1.6504774e+001
  1.8580000e+003 -1.4777568e+002  1.5558871e+001
  1.8590000e+003 -1.1963311e+002  1.4687880e+001
  1.8600000e+003 -1.3801031e+002  1.3896259e+001
  1.8610000e+003 -1.6087439e+002  1.6161444e+001
  1.8620000e+003 -1.0924260e+002  1.5422040e+001
  1.8630000e+003 -1.1474048e+002  1.2077627e+001
  1.8640000e+003 -1.2094813e+002  1.1642304e+001
  1.8650000e+003 -1.1716393e+002  1.1278979e+001
  1.8660000e+003 -1.1410253e+002  1.0981543e+001
  1.8670000e+003 -6.9561963e+001  1.0741715e+001
  1.8680000e+003 -6.7946953e+001  1.0552745e+001
  1.8690000e+003 -6.7794859e+001  1.0406388e+001
  1.8700000e+003 -8.4294756e+001  1.0300502e+001
  1.8710000e+003 -1.0377965e+002  1.0237792e+001
  1.8720000e+003 -9.1498347e+001  1.0212645e+001
  1.8730000e+003 -8.4949744e+001  8.8472542e+000
  1.8740000e+003 -1.1436449e+002  8.8695467e+000
  1.8750000e+003 -1.2905525e+002  8.9140188e+000
  1.8760000e+003 -1.0459453e+002  8.9775428e+000
  1.8770000e+003 -5.7156814e+001  9.0547188e+000
  1.8780000e+003 -4.6324566e+001  9.1401690e+000
  1.8790000e+003 -4.7142947e+001  9.2338035e+000
  1.8800000e+003 -8.8745335e+001  9.3261187e+000
  1.8810000e+003 -5.7810631e+001  9.4168850e+000
  1.8820000e+003 -8.5683286e+001  9.5059554e+000
  1.8830000e+003 -7.1342660e+001  9.5920646e+000
  1.8840000e+003 -6.2671158e+001  9.6725755e+000
  1.8850000e+003 -5.7185751e+001  9.7524461e+000
  1.8860000e+003 -4.4366046e+001  9.8321996e+000
  1.8870000e+003 -5.9182790e+001  8.8680000e+000
  1.8880000e+003 -6.2731770e+001  8.9406250e+000
  1.8890000e+003 -5.3859069e+001  9.0139520e+000
  1.8900000e+003 -4.4448560e+001  9.0926120e+000
  1.8910000e+003 -5.0353459e+001  9.1826733e+000
  1.8920000e+003 -5.1198722e+001  9.2838390e+000
  1.8930000e+003 -5.0577192e+001  9.3902945e+000
  1.8940000e+003 -4.8273821e+001  8.6696580e+000
  1.8950000e+003 -4.1058866e+001  8.7647153e+000
  1.8960000e+003 -3.9562884e+001  8.8587517e+000
  1.8970000e+003 -3.3213539e+001  8.9506983e+000
  1.8980000e+003 -4.1034957e+001  9.0380859e+000
  1.8990000e+003 -3.6566432e+001  9.1079423e+000
  1.9000000e+003 -3.2144736e+001  9.1588693e+000
  1.9010000e+003 -3.4626070e+001  9.2020422e+000
  1.9020000e+003 -2.5707749e+001  9.2362468e+000
  1.9030000e+003 -1.8490054e+001  9.2586366e+000
  1.9040000e+003 -2.7654362e+001  9.2720525e+000
  1.9050000e+003 -4.5005146e+001  9.2777133e+000
  1.9060000e+003 -4.3668776e+001  8.0351848e+000
  1.9070000e+003 -4.0920540e+001  8.0301358e+000
  1.9080000e+003 -4.4854149e+001  8.0214136e+000
  1.9090000e+003 -4.8892273e+001  8.0099868e+000
  1.9100000e+003 -4.8153664e+001  7.9996715e+000
  1.9110000e+003 -4.2703780e+001  7.9893637e+000
  1.9120000e+003 -3.2400779e+001  7.9773690e+000
  1.9130000e+003 -3.4264624e+001  7.9665692e+000
  1.9140000e+003 -2.0671784e+001  7.9580001e+000
  1.9150000e+003 -2.7686133e-001  7.9501619e+000
  1.9160000e+003 -1.8631323e+001  7.9438757e+000
  1.9170000e+003 -3.4145104e+001  7.9399451e+000
  1.9180000e+003 -3.9881387e+001  7.9418637e+000
  1.9190000e+003 -2.8843720e+001  7.9513884e+000
  1.9200000e+003 -1.1769090e+001  7.9670212e+000
  1.9210000e+003 -1.2189740e+001  7.9846276e+000
  1.9220000e+003 -1.2347916e+001  8.0064461e+000
  1.9230000e+003 -2.2859290e+001  8.0355853e+000
  1.9240000e+003 -2.7411261e+001  8.0733500e+000
  1.9250000e+003 -3.2897639e+001  8.1196101e+000
  1.9260000e+003 -2.0946249e+001  8.1712145e+000
  1.9270000e+003 -2.3614260e+001  8.2269051e+000
  1.9280000e+003 -3.0212833e+001  8.2857573e+000
  1.9290000e+003 -4.2127338e+001  7.9147922e+000
  1.9300000e+003 -1.9038574e+001  7.9464721e+000
  1.9310000e+003 -2.0886253e+001  8.0225639e+000
  1.9320000e+003 -1.7801339e+001  8.1035645e+000
  1.9330000e+003 -1.2387868e+001  8.1906317e+000
  1.9340000e+003 -2.0736224e+001  8.2813434e+000
  1.9350000e+003 -1.8264214e+001  8.3735455e+000
  1.9360000e+003 -4.5598790e+000  8.4654337e+000
  1.9370000e+003  2.5652970e+000  8.5568387e+000
  1.9380000e+003  4.4617396e+000  8.6485630e+000
  1.9390000e+003  6.4004194e+000  8.7407746e+000
  1.9400000e+003  1.0479236e+001  8.8312317e+000
  1.9410000e+003  1.3901210e+001  8.9211782e+000
  1.9420000e+003  1.4404510e+001  8.7042939e+000
  1.9430000e+003  1.8389804e+001  8.6373748e+000
  1.9440000e+003  9.2096107e+000  8.7215581e+000
  1.9450000e+003  1.3723391e+000  8.8022986e+000
  1.9460000e+003  1.1337691e+001  8.8800679e+000
  1.9470000e+003  1.1438314e+001  8.9569527e+000
  1.9480000e+003  2.1902635e+001  9.0322771e+000
  1.9490000e+003  3.2027554e+001  9.1042122e+000
  1.9500000e+003  3.5107210e+001  9.1730684e+000
  1.9510000e+003  4.7250030e+001  9.2397177e+000
  1.9520000e+003  4.6859533e+001  9.3041169e+000
  1.9530000e+003  4.8827284e+001  9.3666390e+000
  1.9540000e+003  5.2989067e+001  9.4247520e+000
  1.9550000e+003  5.3502164e+001  9.4786741e+000
  1.9560000e+003  4.5568512e+001  9.5303994e+000
  1.9570000e+003  5.0620120e+001  9.5811166e+000
  1.9580000e+003  6.7987516e+001  9.5202880e+000
  1.9590000e+003  6.4085983e+001  9.2357010e+000
  1.9600000e+003  6.9328955e+001  9.2904954e+000
  1.9610000e+003  8.3370543e+001  9.3458251e+000
  1.9620000e+003  7.6715646e+001  9.4014162e+000
  1.9630000e+003  7.8390646e+001  9.4552267e+000
  1.9640000e+003  8.1780511e+001  9.5076262e+000
  1.9650000e+003  8.3509774e+001  9.5594702e+000
  1.9660000e+003  7.8567892e+001  9.6106433e+000
  1.9670000e+003  6.9667606e+001  9.6632181e+000
  1.9680000e+003  7.6017255e+001  9.7157696e+000
  1.9690000e+003  7.6382047e+001  9.7658901e+000
  1.9700000e+003  7.9383906e+001  9.8169128e+000
  1.9710000e+003  8.4983105e+001  9.8683793e+000
  1.9720000e+003  8.2946612e+001  9.9171047e+000
  1.9730000e+003  8.2548521e+001  9.9640600e+000
  1.9740000e+003  7.4088364e+001  1.0010269e+001
  1.9750000e+003  8.0145617e+001  1.0054751e+001
  1.9760000e+003  7.9144643e+001  1.0098095e+001
  1.9770000e+003  8.1243215e+001  1.0140950e+001
  1.9780000e+003  7.7156513e+001  1.0186149e+001
  1.9790000e+003  8.0091495e+001  1.0234981e+001
  1.9800000e+003  9.8170652e+001  1.0287169e+001
  1.9810000e+003  9.5270104e+001  1.0343499e+001
  1.9820000e+003  8.9818935e+001  1.0403752e+001
  1.9830000e+003  1.1118116e+002  1.0468147e+001
  1.9840000e+003  1.1311642e+002  1.0540452e+001
  1.9850000e+003  8.8275179e+001  1.0619968e+001
  1.9860000e+003  8.9729540e+001  1.0703117e+001
  1.9870000e+003  9.9848871e+001  1.0787685e+001
  1.9880000e+003  1.0158913e+002  1.0874917e+001
  1.9890000e+003  9.3138368e+001  1.0963102e+001
  1.9900000e+003  1.0182096e+002  1.1050411e+001
  1.9910000e+003  9.7590058e+001  1.1139658e+001
  1.9920000e+003  1.1229913e+002  1.1232924e+001
  1.9930000e+003  1.0489331e+002  1.1333167e+001
  1.9940000e+003  1.1150656e+002  1.1441549e+001
  1.9950000e+003  1.2753901e+002  1.1698611e+001
  1.9960000e+003  1.3159131e+002  1.2248711e+001
  1.9970000e+003  1.3599626e+002  1.2283800e+001
  1.9980000e+003  1.3978758e+002  1.2517331e+001
  1.9990000e+003  1.4134159e+002  1.2663533e+001
  2.0000000e+003  1.3622615e+002  1.3507839e+001
  2.0010000e+003  1.4037868e+002  1.3670632e+001
  2.0020000e+003  1.4115129e+002  1.6530449e+001
